##########################################################################################
##            ########       ###########        ####     ###          # ##         #######
## # #   ### #######   ####  #        ##### ###      ###     ########## ## ###############
## # # # # #  ####   #######   ##### ###### #### ####### ### ########            #########
#       #   #      ######### #####        # ####     ### ###          ########## #########
#### ##############          ####### ###### ######## #########################   #########
#      A# # # ###       #### #######        ########                 B                ####
##########################################################################################

